__________________________________
|%%%%%%%%%%%%%%%**%%%%%%%%%%%%%%%|
|%****%********%**%********%****%|
|%****%********%**%********%****%|
|%****%********%**%********%****%|
|%****%********%**%********%****%|
|%%%%%%%%%%%%%%%%%%%%%%%%%%%%%%%%|
|%****%**%**************%**%****%|
|%****%**%**************%**%****%|
|%****%**%**************%**%****%|
|%%%%%%**%%%%%%%**%%%%%%%**%%%%%%|
|*****%********%**%********%*****|
|*****%********%**%********%*****|
|*****%********%**%********%*****|
|*****%********%**%********%*****|
|*****%***%%%%%%%%%%%%%%***%*****|
|*****%***%*****&&*****%***%*****|
|*****%***%*%%%%%%%%%%*%***%*****|
\%%%%%%%%%%*%%%%%%%%%%*%***%*****|
|*****%***%************%%%%%%%%%%\
|*****%***%%%%%%%%%%%%%%***%*****|
|*****%********%**%********%*****|
|*****%********%**%********%*****|
|*****%********%**%********%*****|
|*****%********%**%********%*****|
|%%%%%%**%%%%%%%**%%%%%%%**%%%%%%|
|%****%**%**************%**%****%|
|%****%**%**************%**%****%|
|%****%**%**************%**%****%|
|%%%%%%%%%%%%%%%%%%%%%%%%%%%%%%%%|
|%****%********%**%********%****%|
|%****%********%**%********%****%|
|%****%********%**%********%****%|
|%****%********%**%********%****%|
|%%%%%%%%%%%%%%%**%%%%%%%%%%%%%%%|
__________________________________